1 2 5 5 5 5 5 5 5 5 5 5 5 5 5 1 2
3 4 0 0 0 0 0 0 0 0 0 0 0 0 0 3 4
5 0 0 0 0 0 0 0 0 0 0 6 0 0 0 0 5
5 0 0 6 7 0 0 5 6 0 0 0 5 0 0 7 5
5 0 0 0 0 0 0 5 0 7 0 6 5 0 0 0 5
5 0 6 0 0 0 0 5 0 0 0 0 5 0 6 7 5
5 0 5 0 0 5 0 7 0 0 6 0 5 0 0 0 5
5 7 0 0 5 0 0 0 0 0 6 5 0 0 7 0 5
5 7 5 0 0 5 0 6 0 0 7 0 5 0 7 0 5
5 0 0 6 0 0 0 0 6 0 0 6 0 0 0 7 5
5 0 6 0 0 0 7 0 0 0 0 0 0 0 0 0 5
5 0 0 0 0 0 0 0 7 0 0 0 7 6 0 6 5
5 0 0 6 7 0 6 0 0 0 0 7 0 0 6 0 5
1 2 0 0 0 0 0 0 0 0 0 0 0 0 0 1 2
3 4 5 5 5 5 5 5 5 5 5 5 5 5 5 3 4