1 2 5 5 5 5 5 5 5 5 5 5 5 5 5 5 5 5 1 2
3 4 8 8 8 8 8 8 8 8 8 8 8 8 8 8 8 8 3 4
5 8 7 0 8 0 0 7 0 0 8 7 0 0 8 0 0 8 8 5
5 8 7 0 8 0 0 7 0 0 8 7 0 0 8 0 0 8 8 5
5 8 0 0 8 0 0 0 0 7 8 0 0 7 8 0 0 8 8 5
5 8 0 0 8 0 0 8 0 0 0 0 0 8 6 0 0 0 8 5
5 8 0 6 7 0 0 8 6 0 8 0 6 8 0 7 0 0 8 5
5 8 0 0 0 0 0 8 8 7 8 6 0 8 0 0 0 0 8 5
5 8 6 0 8 8 8 8 8 0 8 0 7 8 6 7 0 0 8 5
5 8 7 0 8 6 0 7 8 8 8 0 0 8 8 8 7 0 8 5
5 8 0 0 8 0 6 0 0 0 7 0 0 8 6 0 0 0 8 5
5 8 6 0 8 7 0 6 0 7 0 0 7 8 0 0 0 0 8 5
5 8 0 6 8 8 8 0 6 0 0 6 0 8 0 7 8 8 8 5
5 8 6 0 8 0 7 0 0 8 0 0 8 8 0 0 7 8 8 5
5 8 0 0 0 0 0 0 7 8 0 0 7 6 0 6 0 8 8 5
5 8 0 6 7 0 6 8 8 8 0 7 0 0 6 0 0 7 8 5
1 2 8 8 8 8 8 8 8 8 8 8 8 8 8 8 8 8 1 2
3 4 5 5 5 5 5 5 5 5 5 5 5 5 5 5 5 5 3 4

